71 14
300 13 0 0 0 0 0 0 0 0 0 0 0 0 0
320 13 0 0 0 0 0 0 0 0 0 0 0 0 0 
340 13 0 0 0 0 0 0 0 0 0 0 0 0 0
360 13 0 0 0 0 0 0 0 0 0 0 0 0 0
380 13 0 0 0 0 0 0 0 0 0 0 0 0 0
400 13 0 0 0 0 0 0 0 0 0 0 0 0 0
420 13 0 0 0 0 0 0 0 0 0 0 0 0 0
440 13 0 0 0 0 0 0 0 0 0 0 0 0 0
460 13 0 0 0 0 0 0 0 0 0 0 0 0 0
480 13 0 0 0 0 0 0 0 0 0 0 0 0 0
500 13 0 0 0 0 0 0 0 0 0 0 0 0 0
520 13 0 0 0 0 0 0 0 0 0 0 0 0 0
540 13 0 0 0 0 0 0 0 0 0 0 0 0 0
560 13 0 0 0 0 0 0 0 0 0 0 0 0 0
