82 9
300 12 0 0 2 2 2 2 2 0 0 4 7 2 
320 12 0 0 6 6 6 6 6 0 0 4 7 2 
340 12 0 0 6 6 6 6 6 0 0 4 7 2 
360 12 0 0 2 2 2 2 2 0 0 4 7 2 
450 13 0 0 2 2 2 2 2 0 1 6 1 1 1 
470 13 0 0 2 2 7 2 2 0 1 6 1 1 1
490 13 0 0 2 7 7 7 2 0 6 6 6 6 6
510 13 0 0 2 2 7 2 2 0 1 6 1 1 1
530 13 0 0 2 2 2 2 2 0 1 6 1 1 1

