82 5
300 12 0 0 2 2 2 2 2 0 0 4 7 2 
320 12 0 0 6 6 6 6 6 0 0 4 7 2 
340 12 0 0 6 6 6 6 6 0 0 4 7 2 
360 12 0 0 2 2 2 2 2 0 0 4 7 2 
380 13 0 0 2 2 2 2 2 0 1 6 1 1 1 

