82 5
300 12 0 0 2 2 2 2 2 0 0 4 7 2 
400 12 0 0 6 6 6 6 6 0 0 4 7 2 
500 12 0 0 6 6 6 6 6 0 0 4 7 2 
600 12 0 0 2 2 2 2 2 0 0 4 7 2 
900 13 0 0 2 2 2 2 2 0 1 6 1 1 1 

