71 12
310 11 0 0 0 0 6 0 0 0 0 0 6
330 11 0 0 0 0 6 0 0 0 0 0 6
350 10 0 0 0 0 0 6 0 0 0 6
370 10 0 0 0 0 0 7 7 7 7 7
390 11 0 0 0 0 7 7 7 7 7 7 7
410 12 0 0 0 7 7 2 7 7 7 2 7 7
430 12 0 0 0 7 7 2 7 7 7 2 7 7
450 12 0 0 0 7 7 7 7 7 7 7 7 7
470 12 0 0 0 7 7 7 7 7 7 7 7 7
490 12 0 0 0 7 7 7 7 7 7 7 7 7
510 11 0 0 0 0 7 0 0 0 0 0 7
530 11 0 0 0 0 7 7 7 0 7 7 7
