71 12
300 11 0 0 0 0 6 0 0 0 0 0 6
320 11 0 0 0 0 6 0 0 0 0 0 6
340 10 0 0 0 0 0 6 0 0 0 6
360 10 0 0 0 0 0 7 7 7 7 7
380 11 0 0 0 0 7 7 7 7 7 7 7
400 12 0 0 0 7 7 2 7 7 7 2 7 7
420 12 0 0 0 7 7 2 7 7 7 2 7 7
440 12 0 0 0 7 7 7 7 7 7 7 7 7
460 12 0 0 0 7 7 7 7 7 7 7 7 7
480 12 0 0 0 7 7 7 7 7 7 7 7 7
500 11 0 0 0 0 7 0 0 0 0 0 7
520 11 0 0 0 0 7 7 7 0 7 7 7
