map0   
82
3 12 0 0 2 2 2 2 2 0 0 4 7 2 ;
4 12 0 0 6 6 6 6 6 0 0 4 7 2 ;
5 12 0 0 6 6 6 6 6 0 0 4 7 2 ;
6 12 0 0 2 2 2 2 2 0 0 4 7 2 ;
9 13 0 0 2 2 2 2 2 0 1 6 1 1 1 ;
10 13 0 0 2 2 7 2 2 0 1 6 1 1 1 ;
11 13 0 0 2 7 7 7 2 0 6 6 6 6 6 ;
12 13 0 0 2 2 7 2 2 0 1 6 1 1 1 ;
13 13 0 0 2 2 2 2 2 0 1 6 1 1 1 ;
255
